%%%%%                                
%%%%%%                               
%%%%%%%                              
%%%%%%%                              
%%%%%%%                              
%%%%%%%%                             
%%%%%%%%                             
%%%%%%%%                             
%%%%%%%%                             
%%%%%%%%                             
%%%%%%%                              
%%%%%%%                              
%%%%%%%                              
%%%%%%%                              
%%%%%%%             %                
%%%%%%             %   %             
%%%%%%            %%  %%             
%%%%%%           %%  %%              
%%%%%            %%  %               
%%%%%           %%  %% %             
%%%%%           %%  % %%             
%%%%           %%  %% %              
%%%%           %%  % %%              
%%%%           %   % %               
%%%            %  %% %               
%%%           %%  % %                
%%            %  %% %                
%%            %  %% %                
%%            %  %%%                 
%            %% %% %                 
%            %% %% %                 
             %  %%%                  
             % %%%%                  
             % %% %                  
            %% %%%                  %
P           % % %%                  %
            % %%%%                 %%
            % %%%                  %%
           %%% %%                  %%
           %%% %%                 %%%
           %%%%%                  %%%
           %. %%                 %%%%
          %%% %%                 %%%%
          %. %%                  %%%%
         %%. %%                 %%%%%
         %% %%                  %%%%%
        %%  %                   %%%%%
        %% %%                  %%%%%%
       %% %%                   %%%%%%
      %%  %                    %%%%%%
      %                       %%%%%%%
                              %%%%%%%
                              %%%%%%%
                              %%%%%%%
                              %%%%%%%
                             %%%%%%%%
                             %%%%%%%%
                             %%%%%%%%
                             %%%%%%%%
                             %%%%%%%%
                              %%%%%%%
                              %%%%%%%
                              %%%%%%%
                               %%%%%%
                                %%%%%
