%%%%%           %%         %%%% %%%%%
%%%%%%          %%         %%%%   %%%
%%%%%%%         %%         %%%%      
%%%%%%%         %%%        %%%%      
%%%%%%%         %%%        %%%%      
%%%%%%%%        %%%        %%%%      
%%%%%%%%        %%%%       %%%%      
%%%%%%%%        %%%%       %%%%      
%%%%%%%%        %%%%%% %%  %%%%      
%%%%%%%%        %%%%%%%%%% %%%%      
%%%%%%%         %%%%%%%%%  %%%%      
%%%%%%%         %%%%%%%%   %%%%      
%%%%%%%         %%%%%%     %%%%      
%%%%%%%         %%%%%      %%%%      
%%%%%%%         %%%%       %%%%      
%%%%%%          %%%        %%%%      
%%%%%%          %%         %%%%      
%%%%%%          %%         %%%%      
%%%%%    %      %%         %%%%      
%%%%%   %%      %%         %%%%      
%%%%%   %       %%         %%%%      
%%%%   %%       %%         %%%%      
%%%%   %        %%         %%%%      
%%%%  %%        %%         %%%%      
%%%   %         %%         %%%%      
%%%   %         %%         %%%%      
%%   %%         %%         %%%%      
%%  %%          %%         %%%%      
%%  %%          %%         %%%%      
%  %%%          %%         %%%%      
%  %%           %%         %%%%      
  %%%           %%         %%%%      
  %%%           %%         %%%%      
 % %            %%         %%%%      
 %%%            %%         %%%%     %
 %%%            %%         %%%%     %
% %%            %%         %%%%    %%
%%%             %%         %%%%    %%
 %%             %%         %%%%    %%
.%%             %%         %%%%   %%%
.%              %%         %%%%   %%%
%%              %%         %%%%  %%%%
%%              %%         %%%%  %%%%
%               %%         %%%%  %%%%
%               %%         %%%% %%%%%
                %%         %%%% %%%%%
                %%         %%%% %%%%%
                %%         %%%%%%%%%%
               %%%         %%%%%%%%%%
               %%%         %%%%%%%%%%
              %%%%         %%%%%%%%%%
             %%%%%         %%%%%%%%%%
           %%%%%%%         %%%%%%%%%%
          %%%%%%%%         %%%%%%%%%%
        %%%%%%%%%%         %%%%%%%%%%
        %%%%%%%%%%         %%%%%%%%%%
        %%  %%%%%%         %%%%%%%%%%
              %%%%         %%%%%%%%%%
              %%%%         %%%%%%%%%%
               %%%         %%%%%%%%%%
               %%%         %%%%%%%%%%
               %%%         %%%%%%%%%%
               %%%         %%%%%%%%%%
               %%%  %%%    %%%%%%%%%%
P               %%  %%%%%  %%%% %%%%%
