%%%%%                                
%%%%%%                               
%%%%%%                               
%%%%%%                               
%%%%%%                               
%%%%%%                               
%%%%%%%                              
%%%%%%                               
%%%%%%                               
%%%%%%                               
%%%%%%                               
%%%%%%                               
%%%%%%                               
%%%%%%                               
%%%%%                                
%%%%%                   %            
%%%%%                % %%            
%%%%%               %% %%            
%%%%                %%%%%            
%%%%               %%%%%             
%%%%               %% %%             
%%%                %%%%              
%%%               %% %%              
%%%               %%.%%              
%%                %%%%               
%%               %% %%               
%%               %%.%%               
%                %%.%%               
%                %%%%                
%               %%.%%                
                %%.%%                
                %%.%%               %
                %%%%                %
               %%.%%                %
               %%.%%               %%
               %% %%               %%
               %%%%                %%
              %%.%%               %%%
              %% %%               %%%
              %%%%                %%%
             %% %%               %%%%
             %%%%%               %%%%
             %%%% P              %%%%
            %% %%               %%%%%
            %% %                %%%%%
            %                   %%%%%
                                %%%%%
                               %%%%%%
                               %%%%%%
                               %%%%%%
                               %%%%%%
                               %%%%%%
                               %%%%%%
                               %%%%%%
                              %%%%%%%
                               %%%%%%
                               %%%%%%
                               %%%%%%
                               %%%%%%
                               %%%%%%
                                %%%%%
