%%%%%%%%%%%                          
%%%%%%%%%%%                          
%%%%%%%%%%%                          
%%%%%%%%%%%                          
%%%%%%%%%%%                          
%%%%%%%%%%%                          
%%%%%%%%%%                           
%%%%%%%%%%                           
%%%%%%%%%%                           
%%%%%%%%%                            
%%%%%%%%%                            
%%%%%%%%%                 % %        
%%%%%%%%                 %%%%        
%%%%%%%%                %%%%         
%%%%%%%                %%%%%         
%%%%%%%                %%%%          
%%%%%%%               %%%%%          
%%%%%%%              %%%%%           
%%%%%%%%%           %%%%%            
%%%%%%%%%           %%%%%            
%%%%%%%%%          %%%%%            %
%%%%%%%%%          %%%%%            %
%%%%%%%%%         %%%%%            %%
%%%%%%%%%         %%%%%           %%%
%%%%%%%%%        %%%%%%          %%%%
%%%%%%%%%        %%%%%           %%%%
%%%%%%%%%        %%%%%          %%%%%
%%%%%%%%        %%%%%%         %%%%%%
%%%%%%%%        %%%%%%         %%%%%%
%%%%%%%         % %%%%        %%%%%%%
%%%%%%%        %%%%%%         %%%%%%%
%%%%%%%        %%%%%%         %%%%%%%
%%%%%%         % %%%%        %%%%%%%%
%%%%%%        %%%%%%%        %%%%%%%%
%%%%%         %%%%%%        %%%%%%%%%
%%%%          % %%%%        %%%%%%%%%
%%%%         %%%%%%%        %%%%%%%%%
%%%          %%%%%%%        %%%%%%%%%
%%          %%%%%%%         %%%%%%%%%
%           %%%%%%%         %%%%%%%%%
%          %%%%%%%%         %%%%%%%%%
           %%.%%%%          %%%%%%%%%
          %%..%%%%P         %%%%%%%%%
          %%.%%%%             %%%%%%%
         %%.%%%%%             %%%%%%%
           .%%%%              %%%%%%%
           %%%%               %%%%%%%
          %%%%               %%%%%%%%
          %%%%               %%%%%%%%
          %                 %%%%%%%%%
                            %%%%%%%%%
                            %%%%%%%%%
                           %%%%%%%%%%
                           %%%%%%%%%%
                           %%%%%%%%%%
                          %%%%%%%%%%%
                          %%%%%%%%%%%
                          %%%%%%%%%%%
                          %%%%%%%%%%%
                          %%%%%%%%%%%
                          %%%%%%%%%%%
